6 9
..####...
###..####
#.*...F.#
#.#..#F.#
#.*..#G.#
#########