8 11
...........
..###.###..
.#...#...#.
.##..#*F.#.
..##*FG##..
....#.#....
.....#.....
...........