11 19
....#####..........
....#...#..........
....#F..#..........
..###..F##.........
..#..F.F.#.........
###.#.##.#...######
#...#.##.#####..**#
#.F..F..........**#
#####.###.#G##..**#
....#.....#########
....#######........