9 8
........
.#####..
.#.G.#..
.#***##.
.#FFF.#.
.#....#.
.#....#.
.######.
........