12 12
############
#...########
#.#.########
#....#G#####
#.#.F..#####
#*#......###
#**.F.#..###
#.#####.####
#..F....####
######..####
############
############