12 20
####################
#..G..F*.##........#
#.#......##...####.#
#........##........#
#........###....#..#
#...#..#....#......#
#..................#
#.......#....#.....#
#......##...#......#
#......#....#......#
#..................#
####################

